5i22222222222222222222222222222222222222222222o5
i3--------------------------------------------1o
6----------------------------------------------4
6------------------------azze------------------4
6---------azzze----789-----------azzzze-----788p
u888889-----------7p5u9--------------------7p555
555555u9---------7p555u88888888888888888888p5555
5555555u888888888p555555555555555555555555555555
