555555555555555555555i222222222222222222222o55555555555555555555555555555555555555555555555555555555555555555555555555i22222222222222222222222222o
55i2222222222222222223---------------------1222222222223----------12222222222222222222222222222222222222222222222222223--------------------------4
i23------------------------------------------------------------------------125555555555523-------------------------------------------------------4
6----------------------------------------------------------------------------12555555523---------------------------------------------------------4
6------------------------------------------------------------------------------1255523------------------------------------ae----7888888889------7p
6--------------------------------------------------------------------------------123--------------------------------ae----------12222o5556------45
6-------------------------------------------------------azzzze-----------------------------------------------------------------------12246------45
6-----------------------------------------------555--------------azze--------------------------------------azzzze-----------------------46------45
6----------------------------------------------555----------------------azze------------------azzzzzze----------------------------------46------45
6----------------azzze------------5555--------555------------------------------------------------------------------ae-------------------46------45
6-------------------------------5555---------------------------------------------789----------------------------------------------------13------45
u88888889---------------------5555---------------------------------------------78p5u89-----------------------------------azzze------------------1o
55555555u89------------------------------------------azzzzzzzzzze------------78p55555u89---------------------------------------------------------4
5555555555u89--------------------------------------------------------------78p555555555u89-------------------------------------------------------4
555555555555u89---------788888888888888888888889-------------------------78p5555555555555u89----------------------------7888888888888888889------4
55555555555555u888888888p5555555555555555555555u8888888888888888888888888p55555555555555555U8888888888888888888888888888p555555555555555u88888888p
