555555555555555555555555555555555555555555555555555555555555555555555555555555555555555555555555555555555555555555555555i22222222222222222222222222o555555555555555555555i222222222222222222222o55555555555i2222222222o555555555555555555555555555555555555555555555555555i222222222222o5555555555555555555555
555555555555555555555555555555i2222222222o555555555555i22222222222222222o555555555555555555i22222222222222222222222222223--------------------------455i2222222222222222223---------------------1222222222223----------122222222o5555555555555i22222222222222222222222222223------------12o55555555555555555555
55555555555555555i2222222222223----------12222222222223-----------------1222222o555555555i23-------------------------------------------------------1223------------------------------------------------------------------------12o555555555i23-------------------------------------------12o555555555555555555
555555555555555i23-------------------------------------------------------------12o55555i23---------------------------------------------------------------------------------------------------------------------------------------12o55555i23-----------------------------------------------12o5555555555555555
5555555555555i23-----------------------------------------------------------------12o5i23------------------------------------------ae------------------------------------ae---------------------------------------------------------1222223---------------------------------------------------12o55555555555555
55555555555i23---------------------------------------------------------------------123-----------------------------------ae------------------------------------------------------------------------------------------------------------------------------------------------ae------azzze-------12o555555555555
55i222222223----------------------------------------------azzzze----------------------------------------------------------------------------------789-----------------------------------------ae-------------------------------------------------------------------------------------------------1222222222o55
556----------------------------azze--------------------------------azze--------------------------------------azzzze-------------------------------456--------------------------------------------------------------------------------------------------------azzzze----------------------------------------455
556------------------------------------------azze-------------------------azze-----------------azzze----------------------------------------------45u89------------ae----------------------------------------------ae--------------------------------------------------------------azzze-------------------455
556--------------azzze--------------azze-----------------------------------------------------------------------------ae--------------azzze--------4555u89------------------------------------------------------------------------------788889-----------------------------ae-------------------------------455
556--------------------------------------------------------------------------------789------------------------------------------------------------455555u89----------------------------------------------------------------------------1222ou9--------------------------------------------------78888888888p55
55u88888888889-------------------------------------------------------------------78p5u89-----------------------------------azzze------------------1o555555u89------------------------------------------------------------------------------45u89-------azzzzzze--------------------azzze-------7p5555555555555
5555555555555u9----------------------------------------788888888889------------78p55555u89---------------------------------------------------------455555555u89----------------------------------------------------------------------------4555u89--------------------------------------------7p55555555555555
55555555555555u88888889----7888888888889----79----78888p5555555555u888888888888p555555555u89-------------------------------------------------------45555555555u89--------------------------------------------------------------------------455555u89-----------------------------------------7p555555555555555
5555555555555555555555u8888p55555555555u8888pu8888p5555555555555555555555555555555555555555u89----------------------------7888888888888888889------4555555555555u89---------788888889----78888888889---------------------------------------45555555u89----------------------78888888888888888p5555555555555555
555555555555555555555555555555555555555555555555555555555555555555555555555555555555555555555u8888888888888888888888888888p55555555555555555u888888p55555555555555u888888888p5555555u8888p555555555u888888888888888888888888888888888888888p555555555u8888888888888888888888p555555555555555555555555555555555